,gender,test_preparation_course,math_score,reading_score,writing_score,total_score,average_score
0,female,none,72,72,74,218,72.66666666666667
1,female,completed,69,90,88,247,82.33333333333333
2,female,none,90,95,93,278,92.66666666666667
3,male,none,47,57,44,148,49.333333333333336
4,male,none,76,78,75,229,76.33333333333333
5,female,none,71,83,78,232,77.33333333333333
6,female,completed,88,95,92,275,91.66666666666667
7,male,none,40,43,39,122,40.666666666666664
8,male,completed,64,64,67,195,65.0
9,female,none,38,60,50,148,49.333333333333336
10,male,none,58,54,52,164,54.666666666666664
11,male,none,40,52,43,135,45.0
12,female,none,65,81,73,219,73.0
13,male,completed,78,72,70,220,73.33333333333333
14,female,none,50,53,58,161,53.666666666666664
15,female,none,69,75,78,222,74.0
16,male,none,88,89,86,263,87.66666666666667
17,female,none,18,32,28,78,26.0
18,male,completed,46,42,46,134,44.666666666666664
19,female,none,54,58,61,173,57.666666666666664
20,male,none,66,69,63,198,66.0
21,female,completed,65,75,70,210,70.0
22,male,none,44,54,53,151,50.333333333333336
23,female,none,69,73,73,215,71.66666666666667
24,male,completed,74,71,80,225,75.0
25,male,none,73,74,72,219,73.0
26,male,none,69,54,55,178,59.333333333333336
27,female,none,67,69,75,211,70.33333333333333
28,male,none,70,70,65,205,68.33333333333333
29,female,none,62,70,75,207,69.0
30,female,none,69,74,74,217,72.33333333333333
31,female,none,63,65,61,189,63.0
32,female,none,56,72,65,193,64.33333333333333
33,male,none,40,42,38,120,40.0
34,male,none,97,87,82,266,88.66666666666667
35,male,completed,81,81,79,241,80.33333333333333
36,female,none,74,81,83,238,79.33333333333333
37,female,none,50,64,59,173,57.666666666666664
38,female,completed,75,90,88,253,84.33333333333333
39,male,none,57,56,57,170,56.666666666666664
40,male,none,55,61,54,170,56.666666666666664
41,female,none,58,73,68,199,66.33333333333333
42,female,none,53,58,65,176,58.666666666666664
43,male,completed,59,65,66,190,63.333333333333336
44,female,none,50,56,54,160,53.333333333333336
45,male,none,65,54,57,176,58.666666666666664
46,female,completed,55,65,62,182,60.666666666666664
47,female,none,66,71,76,213,71.0
48,female,completed,57,74,76,207,69.0
49,male,completed,82,84,82,248,82.66666666666667
50,male,none,53,55,48,156,52.0
51,male,completed,77,69,68,214,71.33333333333333
52,male,none,53,44,42,139,46.333333333333336
53,male,none,88,78,75,241,80.33333333333333
54,female,completed,71,84,87,242,80.66666666666667
55,female,none,33,41,43,117,39.0
56,female,completed,82,85,86,253,84.33333333333333
57,male,none,52,55,49,156,52.0
58,male,completed,58,59,58,175,58.333333333333336
59,female,none,0,17,10,27,9.0
60,male,completed,79,74,72,225,75.0
61,male,none,39,39,34,112,37.333333333333336
62,male,none,62,61,55,178,59.333333333333336
63,female,none,69,80,71,220,73.33333333333333
64,female,none,59,58,59,176,58.666666666666664
65,male,none,67,64,61,192,64.0
66,male,none,45,37,37,119,39.666666666666664
67,female,none,60,72,74,206,68.66666666666667
68,male,none,61,58,56,175,58.333333333333336
69,female,none,39,64,57,160,53.333333333333336
70,female,completed,58,63,73,194,64.66666666666667
71,male,completed,63,55,63,181,60.333333333333336
72,female,none,41,51,48,140,46.666666666666664
73,male,none,61,57,56,174,58.0
74,male,none,49,49,41,139,46.333333333333336
75,male,none,44,41,38,123,41.0
76,male,none,30,26,22,78,26.0
77,male,completed,80,78,81,239,79.66666666666667
78,female,completed,61,74,72,207,69.0
79,female,none,62,68,68,198,66.0
80,female,none,47,49,50,146,48.666666666666664
81,male,none,49,45,45,139,46.333333333333336
82,male,completed,50,47,54,151,50.333333333333336
83,male,none,72,64,63,199,66.33333333333333
84,male,none,42,39,34,115,38.333333333333336
85,female,none,73,80,82,235,78.33333333333333
86,female,none,76,83,88,247,82.33333333333333
87,female,none,71,71,74,216,72.0
88,female,none,58,70,67,195,65.0
89,female,none,73,86,82,241,80.33333333333333
90,female,none,65,72,74,211,70.33333333333333
91,male,none,27,34,36,97,32.333333333333336
92,male,none,71,79,71,221,73.66666666666667
93,male,completed,43,45,50,138,46.0
94,female,none,79,86,92,257,85.66666666666667
95,male,completed,78,81,82,241,80.33333333333333
96,male,completed,65,66,62,193,64.33333333333333
97,female,completed,63,72,70,205,68.33333333333333
98,female,none,58,67,62,187,62.333333333333336
99,female,none,65,67,62,194,64.66666666666667
100,male,none,79,67,67,213,71.0
101,male,completed,68,74,74,216,72.0
102,female,none,85,91,89,265,88.33333333333333
103,male,completed,60,44,47,151,50.333333333333336
104,male,completed,98,86,90,274,91.33333333333333
105,female,none,58,67,72,197,65.66666666666667
106,female,none,87,100,100,287,95.66666666666667
107,male,completed,66,63,64,193,64.33333333333333
108,female,none,52,76,70,198,66.0
109,female,none,70,64,72,206,68.66666666666667
110,female,completed,77,89,98,264,88.0
111,male,none,62,55,49,166,55.333333333333336
112,male,none,54,53,47,154,51.333333333333336
113,female,none,51,58,54,163,54.333333333333336
114,female,completed,99,100,100,299,99.66666666666667
115,male,none,84,77,74,235,78.33333333333333
116,female,none,75,85,82,242,80.66666666666667
117,female,none,78,82,79,239,79.66666666666667
118,female,none,51,63,61,175,58.333333333333336
119,female,none,55,69,65,189,63.0
120,female,completed,79,92,89,260,86.66666666666667
121,male,completed,91,89,92,272,90.66666666666667
122,female,completed,88,93,93,274,91.33333333333333
123,male,none,63,57,56,176,58.666666666666664
124,male,none,83,80,73,236,78.66666666666667
125,female,none,87,95,86,268,89.33333333333333
126,male,none,72,68,67,207,69.0
127,male,completed,65,77,74,216,72.0
128,male,none,82,82,74,238,79.33333333333333
129,female,none,51,49,51,151,50.333333333333336
130,male,none,89,84,82,255,85.0
131,male,completed,53,37,40,130,43.333333333333336
132,male,completed,87,74,70,231,77.0
133,female,completed,75,81,84,240,80.0
134,male,completed,74,79,75,228,76.0
135,male,none,58,55,48,161,53.666666666666664
136,male,completed,51,54,41,146,48.666666666666664
137,male,none,70,55,56,181,60.333333333333336
138,female,none,59,66,67,192,64.0
139,male,completed,71,61,69,201,67.0
140,female,none,76,72,71,219,73.0
141,female,none,59,62,64,185,61.666666666666664
142,female,completed,42,55,54,151,50.333333333333336
143,male,none,57,43,47,147,49.0
144,male,none,88,73,78,239,79.66666666666667
145,female,none,22,39,33,94,31.333333333333332
146,male,none,88,84,75,247,82.33333333333333
147,male,none,73,68,66,207,69.0
148,female,completed,68,75,81,224,74.66666666666667
149,male,completed,100,100,93,293,97.66666666666667
150,male,completed,62,67,69,198,66.0
151,male,none,77,67,68,212,70.66666666666667
152,female,completed,59,70,66,195,65.0
153,male,none,54,49,47,150,50.0
154,male,none,62,67,61,190,63.333333333333336
155,female,completed,70,89,88,247,82.33333333333333
156,female,completed,66,74,78,218,72.66666666666667
157,male,none,60,60,60,180,60.0
158,female,completed,61,86,87,234,78.0
159,male,none,66,62,64,192,64.0
160,male,completed,82,78,74,234,78.0
161,female,completed,75,88,85,248,82.66666666666667
162,male,none,49,53,52,154,51.333333333333336
163,male,none,52,53,49,154,51.333333333333336
164,female,none,81,92,91,264,88.0
165,female,completed,96,100,100,296,98.66666666666667
166,male,completed,53,51,51,155,51.666666666666664
167,female,completed,58,76,78,212,70.66666666666667
168,female,completed,68,83,78,229,76.33333333333333
169,female,completed,67,75,70,212,70.66666666666667
170,male,completed,72,73,74,219,73.0
171,male,none,94,88,78,260,86.66666666666667
172,female,none,79,86,81,246,82.0
173,female,none,63,67,70,200,66.66666666666667
174,female,completed,43,51,54,148,49.333333333333336
175,female,completed,81,91,87,259,86.33333333333333
176,female,completed,46,54,58,158,52.666666666666664
177,female,completed,71,77,77,225,75.0
178,female,completed,52,70,62,184,61.333333333333336
179,female,completed,97,100,100,297,99.0
180,male,completed,62,68,75,205,68.33333333333333
181,female,none,46,64,66,176,58.666666666666664
182,female,none,50,50,47,147,49.0
183,female,none,65,69,70,204,68.0
184,male,completed,45,52,49,146,48.666666666666664
185,male,completed,65,67,65,197,65.66666666666667
186,male,none,80,76,65,221,73.66666666666667
187,male,completed,62,66,68,196,65.33333333333333
188,male,none,48,52,45,145,48.333333333333336
189,female,none,77,88,87,252,84.0
190,female,none,66,65,69,200,66.66666666666667
191,male,completed,76,83,79,238,79.33333333333333
192,female,none,62,64,66,192,64.0
193,male,completed,77,62,62,201,67.0
194,female,completed,69,84,85,238,79.33333333333333
195,male,none,61,55,52,168,56.0
196,male,completed,59,69,65,193,64.33333333333333
197,male,none,55,56,51,162,54.0
198,female,none,45,53,55,153,51.0
199,female,none,78,79,76,233,77.66666666666667
200,female,completed,67,84,86,237,79.0
201,female,none,65,81,77,223,74.33333333333333
202,male,none,69,77,69,215,71.66666666666667
203,female,none,57,69,68,194,64.66666666666667
204,male,none,59,41,42,142,47.333333333333336
205,male,completed,74,71,78,223,74.33333333333333
206,male,none,82,62,62,206,68.66666666666667
207,male,completed,81,80,76,237,79.0
208,female,none,74,81,76,231,77.0
209,female,none,58,61,66,185,61.666666666666664
210,male,completed,80,79,79,238,79.33333333333333
211,male,none,35,28,27,90,30.0
212,female,none,42,62,60,164,54.666666666666664
213,male,completed,60,51,56,167,55.666666666666664
214,male,completed,87,91,81,259,86.33333333333333
215,male,completed,84,83,75,242,80.66666666666667
216,female,completed,83,86,88,257,85.66666666666667
217,female,none,34,42,39,115,38.333333333333336
218,male,none,66,77,70,213,71.0
219,male,completed,61,56,56,173,57.666666666666664
220,female,completed,56,68,74,198,66.0
221,male,none,87,85,73,245,81.66666666666667
222,female,none,55,65,62,182,60.666666666666664
223,male,none,86,80,75,241,80.33333333333333
224,female,completed,52,66,73,191,63.666666666666664
225,female,none,45,56,54,155,51.666666666666664
226,female,none,72,72,71,215,71.66666666666667
227,male,none,57,50,54,161,53.666666666666664
228,male,none,68,72,64,204,68.0
229,female,completed,88,95,94,277,92.33333333333333
230,male,none,76,64,66,206,68.66666666666667
231,male,none,46,43,42,131,43.666666666666664
232,female,none,67,86,83,236,78.66666666666667
233,male,none,92,87,78,257,85.66666666666667
234,male,completed,83,82,84,249,83.0
235,male,none,80,75,77,232,77.33333333333333
236,male,none,63,66,67,196,65.33333333333333
237,female,completed,64,60,74,198,66.0
238,male,none,54,52,51,157,52.333333333333336
239,male,none,84,80,80,244,81.33333333333333
240,male,completed,73,68,66,207,69.0
241,female,none,80,83,83,246,82.0
242,female,none,56,52,55,163,54.333333333333336
243,male,none,59,51,43,153,51.0
244,male,none,75,74,69,218,72.66666666666667
245,male,none,85,76,71,232,77.33333333333333
246,male,none,89,76,74,239,79.66666666666667
247,female,completed,58,70,68,196,65.33333333333333
248,female,none,65,64,62,191,63.666666666666664
249,male,none,68,60,53,181,60.333333333333336
250,male,completed,47,49,49,145,48.333333333333336
251,female,none,71,83,83,237,79.0
252,female,completed,60,70,70,200,66.66666666666667
253,male,none,80,80,72,232,77.33333333333333
254,male,none,54,52,52,158,52.666666666666664
255,female,none,62,73,70,205,68.33333333333333
256,female,none,64,73,68,205,68.33333333333333
257,male,completed,78,77,77,232,77.33333333333333
258,female,none,70,75,78,223,74.33333333333333
259,female,completed,65,81,81,227,75.66666666666667
260,female,completed,64,79,77,220,73.33333333333333
261,male,completed,79,79,78,236,78.66666666666667
262,female,none,44,50,51,145,48.333333333333336
263,female,none,99,93,90,282,94.0
264,male,none,76,73,68,217,72.33333333333333
265,male,none,59,42,41,142,47.333333333333336
266,female,none,63,75,81,219,73.0
267,female,none,69,72,77,218,72.66666666666667
268,female,completed,88,92,95,275,91.66666666666667
269,female,none,71,76,70,217,72.33333333333333
270,male,none,69,63,61,193,64.33333333333333
271,male,none,58,49,42,149,49.666666666666664
272,female,none,47,53,58,158,52.666666666666664
273,female,none,65,70,71,206,68.66666666666667
274,male,completed,88,85,76,249,83.0
275,male,none,83,78,73,234,78.0
276,female,completed,85,92,93,270,90.0
277,female,completed,59,63,75,197,65.66666666666667
278,female,none,65,86,80,231,77.0
279,male,none,73,56,57,186,62.0
280,male,none,53,52,42,147,49.0
281,male,none,45,48,46,139,46.333333333333336
282,female,none,73,79,84,236,78.66666666666667
283,female,completed,70,78,78,226,75.33333333333333
284,female,none,37,46,46,129,43.0
285,male,completed,81,82,82,245,81.66666666666667
286,male,completed,97,82,88,267,89.0
287,female,none,67,89,82,238,79.33333333333333
288,male,none,88,75,76,239,79.66666666666667
289,male,completed,77,76,77,230,76.66666666666667
290,male,none,76,70,68,214,71.33333333333333
291,male,none,86,73,70,229,76.33333333333333
292,male,completed,63,60,57,180,60.0
293,female,none,65,73,75,213,71.0
294,male,completed,78,77,80,235,78.33333333333333
295,male,none,67,62,60,189,63.0
296,male,completed,46,41,43,130,43.333333333333336
297,male,completed,71,74,68,213,71.0
298,male,completed,40,46,50,136,45.333333333333336
299,male,none,90,87,75,252,84.0
300,male,completed,81,78,81,240,80.0
301,male,none,56,54,52,162,54.0
302,female,completed,67,84,81,232,77.33333333333333
303,male,none,80,76,64,220,73.33333333333333
304,female,completed,74,75,83,232,77.33333333333333
305,male,none,69,67,69,205,68.33333333333333
306,male,completed,99,87,81,267,89.0
307,male,none,51,52,44,147,49.0
308,female,none,53,71,67,191,63.666666666666664
309,female,none,49,57,52,158,52.666666666666664
310,female,none,73,76,80,229,76.33333333333333
311,male,none,66,60,57,183,61.0
312,male,completed,67,61,68,196,65.33333333333333
313,female,completed,68,67,69,204,68.0
314,female,completed,59,64,75,198,66.0
315,male,none,71,66,65,202,67.33333333333333
316,female,completed,77,82,91,250,83.33333333333333
317,male,none,83,72,78,233,77.66666666666667
318,male,none,63,71,69,203,67.66666666666667
319,female,none,56,65,63,184,61.333333333333336
320,female,completed,67,79,84,230,76.66666666666667
321,female,none,75,86,79,240,80.0
322,female,none,71,81,80,232,77.33333333333333
323,female,none,43,53,53,149,49.666666666666664
324,female,none,41,46,43,130,43.333333333333336
325,female,none,82,90,94,266,88.66666666666667
326,male,none,61,61,62,184,61.333333333333336
327,male,none,28,23,19,70,23.333333333333332
328,male,completed,82,75,77,234,78.0
329,female,none,41,55,51,147,49.0
330,male,none,71,60,61,192,64.0
331,male,none,47,37,35,119,39.666666666666664
332,male,completed,62,56,53,171,57.0
333,male,none,90,78,81,249,83.0
334,female,none,83,93,95,271,90.33333333333333
335,female,none,61,68,66,195,65.0
336,male,completed,76,70,69,215,71.66666666666667
337,male,none,49,51,43,143,47.666666666666664
338,female,none,24,38,27,89,29.666666666666668
339,female,completed,35,55,60,150,50.0
340,male,none,58,61,52,171,57.0
341,female,none,61,73,63,197,65.66666666666667
342,female,completed,69,76,74,219,73.0
343,male,completed,67,72,67,206,68.66666666666667
344,male,none,79,73,67,219,73.0
345,female,none,72,80,75,227,75.66666666666667
346,male,none,62,61,57,180,60.0
347,female,completed,77,94,95,266,88.66666666666667
348,male,none,75,74,66,215,71.66666666666667
349,male,none,87,74,76,237,79.0
350,female,none,52,65,69,186,62.0
351,male,none,66,57,52,175,58.333333333333336
352,female,completed,63,78,80,221,73.66666666666667
353,female,none,46,58,57,161,53.666666666666664
354,female,none,59,71,70,200,66.66666666666667
355,female,none,61,72,70,203,67.66666666666667
356,male,none,63,61,61,185,61.666666666666664
357,female,completed,42,66,69,177,59.0
358,male,none,59,62,61,182,60.666666666666664
359,female,none,80,90,89,259,86.33333333333333
360,female,none,58,62,59,179,59.666666666666664
361,male,completed,85,84,78,247,82.33333333333333
362,female,none,52,58,58,168,56.0
363,female,none,27,34,32,93,31.0
364,male,none,59,60,58,177,59.0
365,male,completed,49,58,60,167,55.666666666666664
366,male,completed,69,58,53,180,60.0
367,male,none,61,66,61,188,62.666666666666664
368,female,none,44,64,58,166,55.333333333333336
369,female,none,73,84,85,242,80.66666666666667
370,male,none,84,77,71,232,77.33333333333333
371,female,completed,45,73,70,188,62.666666666666664
372,male,none,74,74,72,220,73.33333333333333
373,female,completed,82,97,96,275,91.66666666666667
374,female,none,59,70,73,202,67.33333333333333
375,male,none,46,43,41,130,43.333333333333336
376,female,none,80,90,82,252,84.0
377,female,completed,85,95,100,280,93.33333333333333
378,female,none,71,83,77,231,77.0
379,male,none,66,64,62,192,64.0
380,female,none,80,86,83,249,83.0
381,male,completed,87,100,95,282,94.0
382,male,none,79,81,71,231,77.0
383,female,none,38,49,45,132,44.0
384,female,none,38,43,43,124,41.333333333333336
385,female,none,67,76,75,218,72.66666666666667
386,female,none,64,73,70,207,69.0
387,female,none,57,78,67,202,67.33333333333333
388,female,none,62,64,64,190,63.333333333333336
389,male,none,73,70,75,218,72.66666666666667
390,male,completed,73,67,59,199,66.33333333333333
391,female,none,77,68,77,222,74.0
392,male,none,76,67,67,210,70.0
393,male,completed,57,54,56,167,55.666666666666664
394,female,completed,65,74,77,216,72.0
395,male,none,48,45,41,134,44.666666666666664
396,female,none,50,67,63,180,60.0
397,female,none,85,89,95,269,89.66666666666667
398,male,none,74,63,57,194,64.66666666666667
399,male,none,60,59,54,173,57.666666666666664
400,female,completed,59,54,67,180,60.0
401,male,none,53,43,43,139,46.333333333333336
402,female,none,49,65,55,169,56.333333333333336
403,female,completed,88,99,100,287,95.66666666666667
404,female,none,54,59,62,175,58.333333333333336
405,female,none,63,73,68,204,68.0
406,male,completed,65,65,63,193,64.33333333333333
407,female,none,82,80,77,239,79.66666666666667
408,female,completed,52,57,56,165,55.0
409,male,completed,87,84,85,256,85.33333333333333
410,female,completed,70,71,74,215,71.66666666666667
411,male,completed,84,83,78,245,81.66666666666667
412,male,none,71,66,60,197,65.66666666666667
413,male,completed,63,67,67,197,65.66666666666667
414,female,completed,51,72,79,202,67.33333333333333
415,male,none,84,73,69,226,75.33333333333333
416,male,completed,71,74,68,213,71.0
417,male,none,74,73,67,214,71.33333333333333
418,male,none,68,59,62,189,63.0
419,male,completed,57,56,54,167,55.666666666666664
420,female,completed,82,93,93,268,89.33333333333333
421,female,completed,57,58,64,179,59.666666666666664
422,female,completed,47,58,67,172,57.333333333333336
423,female,completed,59,85,80,224,74.66666666666667
424,male,none,41,39,34,114,38.0
425,female,none,62,67,62,191,63.666666666666664
426,male,none,86,83,86,255,85.0
427,male,none,69,71,65,205,68.33333333333333
428,male,none,65,59,53,177,59.0
429,male,none,68,63,54,185,61.666666666666664
430,male,none,64,66,59,189,63.0
431,female,none,61,72,70,203,67.66666666666667
432,male,none,61,56,55,172,57.333333333333336
433,female,none,47,59,50,156,52.0
434,male,none,73,66,66,205,68.33333333333333
435,male,completed,50,48,53,151,50.333333333333336
436,male,none,75,68,64,207,69.0
437,male,none,75,66,73,214,71.33333333333333
438,male,none,70,56,51,177,59.0
439,male,completed,89,88,82,259,86.33333333333333
440,female,completed,67,81,79,227,75.66666666666667
441,female,none,78,81,80,239,79.66666666666667
442,female,none,59,73,69,201,67.0
443,female,none,73,83,76,232,77.33333333333333
444,male,none,79,82,73,234,78.0
445,female,completed,67,74,77,218,72.66666666666667
446,male,none,69,66,60,195,65.0
447,male,completed,86,81,80,247,82.33333333333333
448,male,none,47,46,42,135,45.0
449,male,none,81,73,72,226,75.33333333333333
450,female,completed,64,85,85,234,78.0
451,female,none,100,92,97,289,96.33333333333333
452,female,none,65,77,74,216,72.0
453,male,none,65,58,49,172,57.333333333333336
454,female,none,53,61,62,176,58.666666666666664
455,male,none,37,56,47,140,46.666666666666664
456,female,none,79,89,89,257,85.66666666666667
457,male,none,53,54,48,155,51.666666666666664
458,female,none,100,100,100,300,100.0
459,male,completed,72,65,68,205,68.33333333333333
460,male,none,53,58,55,166,55.333333333333336
461,male,none,54,54,45,153,51.0
462,female,none,71,70,76,217,72.33333333333333
463,female,none,77,90,91,258,86.0
464,male,completed,75,58,62,195,65.0
465,female,none,84,87,91,262,87.33333333333333
466,female,none,26,31,38,95,31.666666666666668
467,male,completed,72,67,65,204,68.0
468,female,completed,77,88,85,250,83.33333333333333
469,male,none,91,74,76,241,80.33333333333333
470,female,completed,83,85,90,258,86.0
471,female,none,63,69,74,206,68.66666666666667
472,female,completed,68,86,84,238,79.33333333333333
473,female,none,59,67,61,187,62.333333333333336
474,female,completed,90,90,91,271,90.33333333333333
475,female,completed,71,76,83,230,76.66666666666667
476,male,completed,76,62,66,204,68.0
477,male,none,80,68,72,220,73.33333333333333
478,female,none,55,64,70,189,63.0
479,male,none,76,71,67,214,71.33333333333333
480,male,completed,73,71,68,212,70.66666666666667
481,female,none,52,59,56,167,55.666666666666664
482,male,none,68,68,61,197,65.66666666666667
483,male,none,59,52,46,157,52.333333333333336
484,female,none,49,52,54,155,51.666666666666664
485,male,none,70,74,71,215,71.66666666666667
486,male,none,61,47,56,164,54.666666666666664
487,female,none,60,75,74,209,69.66666666666667
488,male,completed,64,53,57,174,58.0
489,male,completed,79,82,82,243,81.0
490,female,none,65,85,76,226,75.33333333333333
491,female,none,64,64,70,198,66.0
492,female,none,83,83,90,256,85.33333333333333
493,female,none,81,88,90,259,86.33333333333333
494,female,none,54,64,68,186,62.0
495,male,completed,68,64,66,198,66.0
496,female,none,54,48,52,154,51.333333333333336
497,female,completed,59,78,76,213,71.0
498,female,none,66,69,68,203,67.66666666666667
499,male,none,76,71,72,219,73.0
500,female,none,74,79,82,235,78.33333333333333
501,female,completed,94,87,92,273,91.0
502,male,none,63,61,54,178,59.333333333333336
503,female,completed,95,89,92,276,92.0
504,female,none,40,59,54,153,51.0
505,female,none,82,82,80,244,81.33333333333333
506,male,none,68,70,66,204,68.0
507,male,none,55,59,54,168,56.0
508,male,none,79,78,77,234,78.0
509,female,none,86,92,87,265,88.33333333333333
510,male,none,76,71,73,220,73.33333333333333
511,male,none,64,50,43,157,52.333333333333336
512,male,none,62,49,52,163,54.333333333333336
513,female,completed,54,61,62,177,59.0
514,female,completed,77,97,94,268,89.33333333333333
515,female,completed,76,87,85,248,82.66666666666667
516,female,none,74,89,84,247,82.33333333333333
517,female,completed,66,74,73,213,71.0
518,female,completed,66,78,78,222,74.0
519,female,completed,67,78,79,224,74.66666666666667
520,male,none,71,49,52,172,57.333333333333336
521,female,none,91,86,84,261,87.0
522,male,none,69,58,57,184,61.333333333333336
523,male,none,54,59,50,163,54.333333333333336
524,male,completed,53,52,49,154,51.333333333333336
525,male,none,68,60,59,187,62.333333333333336
526,male,completed,56,61,60,177,59.0
527,female,none,36,53,43,132,44.0
528,female,none,29,41,47,117,39.0
529,female,none,62,74,70,206,68.66666666666667
530,female,completed,68,67,73,208,69.33333333333333
531,female,none,47,54,53,154,51.333333333333336
532,male,completed,62,61,58,181,60.333333333333336
533,female,completed,79,88,94,261,87.0
534,male,completed,73,69,68,210,70.0
535,female,completed,66,83,83,232,77.33333333333333
536,male,completed,51,60,58,169,56.333333333333336
537,female,none,51,66,62,179,59.666666666666664
538,male,completed,85,66,71,222,74.0
539,male,completed,97,92,86,275,91.66666666666667
540,male,completed,75,69,68,212,70.66666666666667
541,male,completed,79,82,80,241,80.33333333333333
542,female,none,81,77,79,237,79.0
543,female,none,82,95,89,266,88.66666666666667
544,female,none,64,63,66,193,64.33333333333333
545,male,completed,78,83,80,241,80.33333333333333
546,female,completed,92,100,97,289,96.33333333333333
547,male,completed,72,67,64,203,67.66666666666667
548,female,none,62,67,64,193,64.33333333333333
549,male,none,79,72,69,220,73.33333333333333
550,male,none,79,76,65,220,73.33333333333333
551,male,completed,87,90,88,265,88.33333333333333
552,female,none,40,48,50,138,46.0
553,male,none,77,62,64,203,67.66666666666667
554,male,none,53,45,40,138,46.0
555,female,none,32,39,33,104,34.666666666666664
556,female,completed,55,72,79,206,68.66666666666667
557,male,none,61,67,66,194,64.66666666666667
558,female,none,53,70,70,193,64.33333333333333
559,male,none,73,66,62,201,67.0
560,female,completed,74,75,79,228,76.0
561,female,none,63,74,74,211,70.33333333333333
562,male,completed,96,90,92,278,92.66666666666667
563,female,completed,63,80,80,223,74.33333333333333
564,male,none,48,51,46,145,48.333333333333336
565,male,none,48,43,45,136,45.333333333333336
566,female,completed,92,100,100,292,97.33333333333333
567,female,completed,61,71,78,210,70.0
568,male,none,63,48,47,158,52.666666666666664
569,male,none,68,68,67,203,67.66666666666667
570,male,completed,71,75,70,216,72.0
571,male,none,91,96,92,279,93.0
572,female,none,53,62,56,171,57.0
573,female,completed,50,66,64,180,60.0
574,female,none,74,81,71,226,75.33333333333333
575,male,completed,40,55,53,148,49.333333333333336
576,male,completed,61,51,52,164,54.666666666666664
577,female,none,81,91,89,261,87.0
578,female,completed,48,56,58,162,54.0
579,female,none,53,61,68,182,60.666666666666664
580,female,none,81,97,96,274,91.33333333333333
581,female,none,77,79,80,236,78.66666666666667
582,female,none,63,73,78,214,71.33333333333333
583,female,completed,73,75,80,228,76.0
584,female,none,69,77,77,223,74.33333333333333
585,female,none,65,76,76,217,72.33333333333333
586,female,none,55,73,73,201,67.0
587,female,none,44,63,62,169,56.333333333333336
588,female,none,54,64,65,183,61.0
589,female,none,48,66,65,179,59.666666666666664
590,male,none,58,57,54,169,56.333333333333336
591,male,none,71,62,50,183,61.0
592,male,none,68,68,64,200,66.66666666666667
593,female,none,74,76,73,223,74.33333333333333
594,female,completed,92,100,99,291,97.0
595,female,completed,56,79,72,207,69.0
596,male,none,30,24,15,69,23.0
597,male,none,53,54,48,155,51.666666666666664
598,female,none,69,77,73,219,73.0
599,female,none,65,82,81,228,76.0
600,female,none,54,60,63,177,59.0
601,female,none,29,29,30,88,29.333333333333332
602,female,none,76,78,80,234,78.0
603,male,none,60,57,51,168,56.0
604,male,completed,84,89,90,263,87.66666666666667
605,male,none,75,72,62,209,69.66666666666667
606,female,none,85,84,82,251,83.66666666666667
607,female,none,40,58,54,152,50.666666666666664
608,female,none,61,64,62,187,62.333333333333336
609,female,none,58,63,65,186,62.0
610,male,completed,69,60,63,192,64.0
611,female,none,58,59,66,183,61.0
612,male,completed,94,90,91,275,91.66666666666667
613,female,none,65,77,74,216,72.0
614,female,none,82,93,93,268,89.33333333333333
615,female,none,60,68,72,200,66.66666666666667
616,female,none,37,45,38,120,40.0
617,male,none,88,78,83,249,83.0
618,male,none,95,81,84,260,86.66666666666667
619,male,completed,65,73,68,206,68.66666666666667
620,female,none,35,61,54,150,50.0
621,male,none,62,63,56,181,60.333333333333336
622,male,completed,58,51,52,161,53.666666666666664
623,male,completed,100,96,86,282,94.0
624,female,none,61,58,62,181,60.333333333333336
625,male,completed,100,97,99,296,98.66666666666667
626,male,completed,69,70,63,202,67.33333333333333
627,male,none,61,48,46,155,51.666666666666664
628,male,none,49,57,46,152,50.666666666666664
629,female,completed,44,51,55,150,50.0
630,male,none,67,64,70,201,67.0
631,male,none,79,60,65,204,68.0
632,female,completed,66,74,81,221,73.66666666666667
633,female,none,75,88,85,248,82.66666666666667
634,male,none,84,84,80,248,82.66666666666667
635,male,none,71,74,64,209,69.66666666666667
636,female,completed,67,80,81,228,76.0
637,female,completed,80,92,88,260,86.66666666666667
638,male,none,86,76,74,236,78.66666666666667
639,female,none,76,74,73,223,74.33333333333333
640,male,none,41,52,51,144,48.0
641,female,completed,74,88,90,252,84.0
642,female,none,72,81,79,232,77.33333333333333
643,female,completed,74,79,80,233,77.66666666666667
644,male,none,70,65,60,195,65.0
645,female,completed,65,81,81,227,75.66666666666667
646,female,none,59,70,65,194,64.66666666666667
647,female,none,64,62,68,194,64.66666666666667
648,female,none,50,53,55,158,52.666666666666664
649,female,completed,69,79,81,229,76.33333333333333
650,male,completed,51,56,53,160,53.333333333333336
651,female,completed,68,80,76,224,74.66666666666667
652,female,completed,85,86,98,269,89.66666666666667
653,female,completed,65,70,74,209,69.66666666666667
654,female,none,73,79,79,231,77.0
655,female,none,62,67,67,196,65.33333333333333
656,male,none,77,67,64,208,69.33333333333333
657,male,none,69,66,61,196,65.33333333333333
658,female,none,43,60,58,161,53.666666666666664
659,male,none,90,87,85,262,87.33333333333333
660,male,none,74,77,73,224,74.66666666666667
661,male,none,73,66,63,202,67.33333333333333
662,female,none,55,71,69,195,65.0
663,female,none,65,69,67,201,67.0
664,male,none,80,63,63,206,68.66666666666667
665,female,completed,50,60,60,170,56.666666666666664
666,female,completed,63,73,71,207,69.0
667,female,none,77,85,87,249,83.0
668,male,none,73,74,61,208,69.33333333333333
669,male,completed,81,72,77,230,76.66666666666667
670,female,none,66,76,68,210,70.0
671,male,none,52,57,50,159,53.0
672,female,none,69,78,76,223,74.33333333333333
673,female,completed,65,84,84,233,77.66666666666667
674,female,completed,69,77,78,224,74.66666666666667
675,female,completed,50,64,66,180,60.0
676,female,completed,73,78,76,227,75.66666666666667
677,female,completed,70,82,76,228,76.0
678,male,none,81,75,78,234,78.0
679,male,none,63,61,60,184,61.333333333333336
680,female,none,67,72,74,213,71.0
681,male,none,60,68,60,188,62.666666666666664
682,male,none,62,55,54,171,57.0
683,female,completed,29,40,44,113,37.666666666666664
684,male,completed,62,66,68,196,65.33333333333333
685,female,completed,94,99,100,293,97.66666666666667
686,male,completed,85,75,68,228,76.0
687,male,none,77,78,73,228,76.0
688,male,none,53,58,44,155,51.666666666666664
689,male,none,93,90,83,266,88.66666666666667
690,female,none,49,53,53,155,51.666666666666664
691,female,none,73,76,78,227,75.66666666666667
692,female,completed,66,74,81,221,73.66666666666667
693,female,none,77,77,73,227,75.66666666666667
694,female,none,49,63,56,168,56.0
695,female,none,79,89,86,254,84.66666666666667
696,female,completed,75,82,90,247,82.33333333333333
697,female,none,59,72,70,201,67.0
698,female,completed,57,78,79,214,71.33333333333333
699,male,none,66,66,59,191,63.666666666666664
700,female,completed,79,81,82,242,80.66666666666667
701,female,none,57,67,72,196,65.33333333333333
702,male,completed,87,84,87,258,86.0
703,female,none,63,64,67,194,64.66666666666667
704,female,completed,59,63,64,186,62.0
705,male,none,62,72,65,199,66.33333333333333
706,male,none,46,34,36,116,38.666666666666664
707,male,none,66,59,52,177,59.0
708,male,none,89,87,79,255,85.0
709,female,completed,42,61,58,161,53.666666666666664
710,male,completed,93,84,90,267,89.0
711,female,completed,80,85,85,250,83.33333333333333
712,female,none,98,100,99,297,99.0
713,male,none,81,81,84,246,82.0
714,female,completed,60,70,74,204,68.0
715,female,completed,76,94,87,257,85.66666666666667
716,male,completed,73,78,72,223,74.33333333333333
717,female,completed,96,96,99,291,97.0
718,female,none,76,76,74,226,75.33333333333333
719,male,completed,91,73,80,244,81.33333333333333
720,female,none,62,72,70,204,68.0
721,male,completed,55,59,59,173,57.666666666666664
722,female,completed,74,90,88,252,84.0
723,male,none,50,48,42,140,46.666666666666664
724,male,none,47,43,41,131,43.666666666666664
725,male,completed,81,74,71,226,75.33333333333333
726,female,completed,65,75,77,217,72.33333333333333
727,male,completed,68,51,57,176,58.666666666666664
728,female,none,73,92,84,249,83.0
729,male,none,53,39,37,129,43.0
730,female,completed,68,77,80,225,75.0
731,male,none,55,46,43,144,48.0
732,female,completed,87,89,94,270,90.0
733,male,none,55,47,44,146,48.666666666666664
734,female,none,53,58,57,168,56.0
735,male,none,67,57,59,183,61.0
736,male,none,92,79,84,255,85.0
737,female,completed,53,66,73,192,64.0
738,male,none,81,71,73,225,75.0
739,male,none,61,60,55,176,58.666666666666664
740,male,none,80,73,72,225,75.0
741,female,none,37,57,56,150,50.0
742,female,none,81,84,82,247,82.33333333333333
743,female,completed,59,73,72,204,68.0
744,male,none,55,55,47,157,52.333333333333336
745,male,none,72,79,74,225,75.0
746,male,none,69,75,71,215,71.66666666666667
747,male,none,69,64,68,201,67.0
748,female,none,50,60,59,169,56.333333333333336
749,male,completed,87,84,86,257,85.66666666666667
750,male,completed,71,69,68,208,69.33333333333333
751,male,none,68,72,65,205,68.33333333333333
752,male,completed,79,77,75,231,77.0
753,female,completed,77,90,85,252,84.0
754,male,none,58,55,53,166,55.333333333333336
755,female,none,84,95,92,271,90.33333333333333
756,male,none,55,58,52,165,55.0
757,male,completed,70,68,72,210,70.0
758,female,completed,52,59,65,176,58.666666666666664
759,male,completed,69,77,77,223,74.33333333333333
760,female,none,53,72,64,189,63.0
761,female,none,48,58,54,160,53.333333333333336
762,male,completed,78,81,86,245,81.66666666666667
763,female,none,62,62,63,187,62.333333333333336
764,male,none,60,63,59,182,60.666666666666664
765,female,none,74,72,72,218,72.66666666666667
766,female,completed,58,75,77,210,70.0
767,male,completed,76,62,60,198,66.0
768,female,none,68,71,75,214,71.33333333333333
769,male,none,58,60,57,175,58.333333333333336
770,male,none,52,48,49,149,49.666666666666664
771,male,none,75,73,74,222,74.0
772,female,completed,52,67,72,191,63.666666666666664
773,female,none,62,78,79,219,73.0
774,male,none,66,65,60,191,63.666666666666664
775,female,none,49,58,55,162,54.0
776,female,none,66,72,70,208,69.33333333333333
777,female,none,35,44,43,122,40.666666666666664
778,female,completed,72,79,82,233,77.66666666666667
779,male,completed,94,85,82,261,87.0
780,female,none,46,56,57,159,53.0
781,female,none,77,90,84,251,83.66666666666667
782,female,completed,76,85,82,243,81.0
783,female,completed,52,59,62,173,57.666666666666664
784,male,completed,91,81,79,251,83.66666666666667
785,female,completed,32,51,44,127,42.333333333333336
786,female,none,72,79,77,228,76.0
787,female,none,19,38,32,89,29.666666666666668
788,male,none,68,65,61,194,64.66666666666667
789,female,none,52,65,61,178,59.333333333333336
790,female,none,48,62,60,170,56.666666666666664
791,female,none,60,66,70,196,65.33333333333333
792,male,none,66,74,69,209,69.66666666666667
793,male,completed,89,84,77,250,83.33333333333333
794,female,none,42,52,51,145,48.333333333333336
795,female,completed,57,68,73,198,66.0
796,male,none,70,70,70,210,70.0
797,female,none,70,84,81,235,78.33333333333333
798,male,none,69,60,54,183,61.0
799,female,none,52,55,57,164,54.666666666666664
800,male,completed,67,73,68,208,69.33333333333333
801,male,completed,76,80,73,229,76.33333333333333
802,female,none,87,94,95,276,92.0
803,female,none,82,85,87,254,84.66666666666667
804,female,none,73,76,78,227,75.66666666666667
805,male,none,75,81,74,230,76.66666666666667
806,female,none,64,74,75,213,71.0
807,female,none,41,45,40,126,42.0
808,male,none,90,75,69,234,78.0
809,male,none,59,54,51,164,54.666666666666664
810,male,none,51,31,36,118,39.333333333333336
811,male,none,45,47,49,141,47.0
812,female,completed,54,64,67,185,61.666666666666664
813,male,completed,87,84,76,247,82.33333333333333
814,female,none,72,80,83,235,78.33333333333333
815,male,completed,94,86,87,267,89.0
816,female,none,45,59,64,168,56.0
817,male,completed,61,70,76,207,69.0
818,female,none,60,72,68,200,66.66666666666667
819,female,none,77,91,88,256,85.33333333333333
820,female,completed,85,90,92,267,89.0
821,female,none,78,90,93,261,87.0
822,male,completed,49,52,51,152,50.666666666666664
823,female,none,71,87,82,240,80.0
824,female,none,48,58,52,158,52.666666666666664
825,male,none,62,67,58,187,62.333333333333336
826,female,completed,56,68,70,194,64.66666666666667
827,female,none,65,69,76,210,70.0
828,female,completed,69,86,81,236,78.66666666666667
829,male,none,68,54,53,175,58.333333333333336
830,female,none,61,60,57,178,59.333333333333336
831,female,completed,74,86,89,249,83.0
832,male,none,64,60,58,182,60.666666666666664
833,female,completed,77,82,89,248,82.66666666666667
834,male,none,58,50,45,153,51.0
835,female,completed,60,64,74,198,66.0
836,male,none,73,64,57,194,64.66666666666667
837,female,completed,75,82,79,236,78.66666666666667
838,male,completed,58,57,53,168,56.0
839,female,none,66,77,73,216,72.0
840,female,none,39,52,46,137,45.666666666666664
841,male,none,64,58,51,173,57.666666666666664
842,female,completed,23,44,36,103,34.333333333333336
843,male,completed,74,77,76,227,75.66666666666667
844,female,completed,40,65,64,169,56.333333333333336
845,male,none,90,85,84,259,86.33333333333333
846,male,completed,91,85,85,261,87.0
847,male,none,64,54,50,168,56.0
848,female,none,59,72,68,199,66.33333333333333
849,male,none,80,75,69,224,74.66666666666667
850,male,none,71,67,67,205,68.33333333333333
851,female,none,61,68,63,192,64.0
852,female,none,87,85,93,265,88.33333333333333
853,male,none,82,67,61,210,70.0
854,male,none,62,64,55,181,60.333333333333336
855,female,none,97,97,96,290,96.66666666666667
856,male,none,75,68,65,208,69.33333333333333
857,female,none,65,79,81,225,75.0
858,male,completed,52,49,46,147,49.0
859,male,none,87,73,72,232,77.33333333333333
860,female,none,53,62,53,168,56.0
861,female,none,81,86,87,254,84.66666666666667
862,male,completed,39,42,38,119,39.666666666666664
863,female,completed,71,71,80,222,74.0
864,male,none,97,93,91,281,93.66666666666667
865,male,completed,82,82,88,252,84.0
866,male,none,59,53,52,164,54.666666666666664
867,male,none,61,42,41,144,48.0
868,male,completed,78,74,72,224,74.66666666666667
869,male,none,49,51,51,151,50.333333333333336
870,male,none,59,58,47,164,54.666666666666664
871,female,completed,70,72,76,218,72.66666666666667
872,male,completed,82,84,78,244,81.33333333333333
873,male,none,90,90,82,262,87.33333333333333
874,female,none,43,62,61,166,55.333333333333336
875,male,none,80,64,66,210,70.0
876,male,none,81,82,84,247,82.33333333333333
877,male,none,57,61,54,172,57.333333333333336
878,female,none,59,72,80,211,70.33333333333333
879,female,none,64,76,74,214,71.33333333333333
880,male,completed,63,64,66,193,64.33333333333333
881,female,completed,71,70,70,211,70.33333333333333
882,female,none,64,73,71,208,69.33333333333333
883,male,none,55,46,44,145,48.333333333333336
884,female,none,51,51,54,156,52.0
885,female,completed,62,76,80,218,72.66666666666667
886,female,completed,93,100,95,288,96.0
887,male,none,54,72,59,185,61.666666666666664
888,female,none,69,65,74,208,69.33333333333333
889,male,none,44,51,48,143,47.666666666666664
890,female,completed,86,85,91,262,87.33333333333333
891,female,none,85,92,85,262,87.33333333333333
892,female,none,50,67,73,190,63.333333333333336
893,male,completed,88,74,75,237,79.0
894,female,none,59,62,69,190,63.333333333333336
895,female,none,32,34,38,104,34.666666666666664
896,male,none,36,29,27,92,30.666666666666668
897,female,completed,63,78,79,220,73.33333333333333
898,male,completed,67,54,63,184,61.333333333333336
899,female,completed,65,78,82,225,75.0
900,male,none,85,84,89,258,86.0
901,female,none,73,78,74,225,75.0
902,female,completed,34,48,41,123,41.0
903,female,completed,93,100,100,293,97.66666666666667
904,female,none,67,84,84,235,78.33333333333333
905,male,none,88,77,77,242,80.66666666666667
906,male,none,57,48,51,156,52.0
907,female,completed,79,84,91,254,84.66666666666667
908,female,none,67,75,72,214,71.33333333333333
909,male,completed,70,64,70,204,68.0
910,male,none,50,42,48,140,46.666666666666664
911,female,none,69,84,82,235,78.33333333333333
912,female,completed,52,61,66,179,59.666666666666664
913,female,completed,47,62,66,175,58.333333333333336
914,female,none,46,61,55,162,54.0
915,female,none,68,70,66,204,68.0
916,male,completed,100,100,100,300,100.0
917,female,none,44,61,52,157,52.333333333333336
918,female,completed,57,77,80,214,71.33333333333333
919,male,completed,91,96,91,278,92.66666666666667
920,male,none,69,70,67,206,68.66666666666667
921,female,none,35,53,46,134,44.666666666666664
922,male,none,72,66,66,204,68.0
923,female,none,54,65,65,184,61.333333333333336
924,male,none,74,70,69,213,71.0
925,male,completed,74,64,60,198,66.0
926,male,none,64,56,52,172,57.333333333333336
927,female,completed,65,61,71,197,65.66666666666667
928,male,completed,46,43,44,133,44.333333333333336
929,female,none,48,56,51,155,51.666666666666664
930,male,completed,67,74,70,211,70.33333333333333
931,male,none,62,57,62,181,60.333333333333336
932,male,completed,61,71,73,205,68.33333333333333
933,male,completed,70,75,74,219,73.0
934,male,completed,98,87,90,275,91.66666666666667
935,male,none,70,63,58,191,63.666666666666664
936,male,none,67,57,53,177,59.0
937,female,none,57,58,57,172,57.333333333333336
938,male,completed,85,81,85,251,83.66666666666667
939,male,completed,77,68,69,214,71.33333333333333
940,male,completed,72,66,72,210,70.0
941,female,none,78,91,96,265,88.33333333333333
942,male,none,81,66,64,211,70.33333333333333
943,male,completed,61,62,61,184,61.333333333333336
944,female,none,58,68,61,187,62.333333333333336
945,female,none,54,61,58,173,57.666666666666664
946,male,none,82,82,80,244,81.33333333333333
947,female,none,49,58,60,167,55.666666666666664
948,male,completed,49,50,52,151,50.333333333333336
949,female,completed,57,75,73,205,68.33333333333333
950,male,none,94,73,71,238,79.33333333333333
951,female,completed,75,77,83,235,78.33333333333333
952,female,none,74,74,72,220,73.33333333333333
953,male,completed,58,52,54,164,54.666666666666664
954,female,none,62,69,69,200,66.66666666666667
955,male,none,72,57,62,191,63.666666666666664
956,male,none,84,87,81,252,84.0
957,female,none,92,100,100,292,97.33333333333333
958,female,none,45,63,59,167,55.666666666666664
959,male,none,75,81,71,227,75.66666666666667
960,female,none,56,58,64,178,59.333333333333336
961,female,none,48,54,53,155,51.666666666666664
962,female,none,100,100,100,300,100.0
963,female,completed,65,76,75,216,72.0
964,male,none,72,57,58,187,62.333333333333336
965,female,none,62,70,72,204,68.0
966,male,completed,66,68,64,198,66.0
967,male,none,63,63,60,186,62.0
968,female,none,68,76,67,211,70.33333333333333
969,female,none,75,84,80,239,79.66666666666667
970,female,none,89,100,100,289,96.33333333333333
971,male,completed,78,72,69,219,73.0
972,female,completed,53,50,60,163,54.333333333333336
973,female,none,49,65,61,175,58.333333333333336
974,female,none,54,63,67,184,61.333333333333336
975,female,completed,64,82,77,223,74.33333333333333
976,male,completed,60,62,60,182,60.666666666666664
977,male,none,62,65,58,185,61.666666666666664
978,male,completed,55,41,48,144,48.0
979,female,none,91,95,94,280,93.33333333333333
980,female,none,8,24,23,55,18.333333333333332
981,male,none,81,78,78,237,79.0
982,male,completed,79,85,86,250,83.33333333333333
983,female,completed,78,87,91,256,85.33333333333333
984,female,none,74,75,82,231,77.0
985,male,none,57,51,54,162,54.0
986,female,none,40,59,51,150,50.0
987,male,completed,81,75,76,232,77.33333333333333
988,female,none,44,45,45,134,44.666666666666664
989,female,completed,67,86,83,236,78.66666666666667
990,male,completed,86,81,75,242,80.66666666666667
991,female,completed,65,82,78,225,75.0
992,female,none,55,76,76,207,69.0
993,female,none,62,72,74,208,69.33333333333333
994,male,none,63,63,62,188,62.666666666666664
995,female,completed,88,99,95,282,94.0
996,male,none,62,55,55,172,57.333333333333336
997,female,completed,59,71,65,195,65.0
998,female,completed,68,78,77,223,74.33333333333333
999,female,none,77,86,86,249,83.0
